täita - заполнить, выполнить
kõikjal - везде
avaldan - выражаю, признаюсь
tähtsa - важный
enamik - большинство
ei mõista - не понимают
elu leiab aset - жизнь происходит
kipuvad - склонны
sündmus - событие
viisil - способ
elada täiel rinnal - жить полной жизнью
edukas - успешный
käesolevas hetkes - в настоящий момент
pidevalt - постоянно
justkui - как бы
võibki - может
asjatu - бесполезный
tänamatu - неблагодарный
kaevamine - копание
ennustamine - предсказание
ealeski - никогда
elu keerdkäike - повороты жизни
mitmekesisus - разнообразие
ettearvamatus - неопределенность
lõhub - разрушает
ennastunustavalt - самозабвенно
keskendub - сосредотачивается
keskenduvad - сосредотачиваются
toimuma - происходить
kujuta ette - представь
segada - беспокоить
tegutseb - действует
süüd - вина
luhtunud - провалившийся
varasemate - предыдущие
ei püüa - не пытается
ennustada - предсказывать
pühendumine - преданность
lahendada - решить
seisvaid - стоящие
ülesandeid - задачи
kvaliteetselt - качественно
tegevusetus - бездействие
üritavad - пытаются
korraga - одновременно
sisustamine - наполнение
tormates - бросаясь
lahendusi - решения
hetkes elades - живя в настоящем
jättes - оставляя
tegevusetult - бездейственно
veedad aega - проводишь время
täiesti - полностью
välja lülitama - выключить
taas - снова
loovus - творчество
täiesti uudseid lahendusi - совершенно новые решения
lükkavad - отталкивают
pidevalt - постоянно
hetkes - в настоящий момент
olema julge - быть смелым
kartmatu - бесстрашный
hakkama pihta - начать
kaalutlemine - обдумывание
arukad - разумные
tegevused - действия
tõelise - настоящий
vastandid - противоположности
alustad otsast - начинаешь сначала
niikuinii - в любом случае
laskma - позволить
vanematele inimestele - старшим людям
Edukas ettevõtja - успешный предприниматель
Hakka kohe pihta! - Начни сразу!
Ajakirjanik - журналист
täpsustavaid - уточняющие
ikkagi - все-таки
pöörduda - обратиться
jäi endale kindlaks - остался верным себе
liigne targutamine - излишнее болтовня
uurimine - исследование
viib fookuse - направляет фокус
kõrvale - в сторону
keskenduda alustamisele - сосредоточиться на начале
võtta kätte - взяться за
suurepäraseid - великолепные
häid - хорошие
kavatsusi - намерения
nõuandest - совет
hetk - момент
välja jõudma - добраться
teekond - путь
edasiminek - продвижение
ala - область
pühendub - посвящает
jäägitult - без остатка
just - именно
LAPSELIKULT - Детский
Teinekord - Иногда
jällegi - снова
suunata - направить
Palgatakse - Нанимают
pidama, pidada, peab - проводить
karm - жесткий
Nimelt - Намеренно
kena - красивый
kaalukomme - конфеты на развес
kasumiga maha müüma - продавать с прибылью
leiutas - изобрел
ühe viisi - один способ
mõjutas tugevalt - сильно повлияло
isa alkoholi- ja umastisõltuvus - отцовскую алкогольную и наркотическую зависимость
tüliderohke - конфликтный
endamisi - про себя
üsna - довольно
tavapärane - обычный
arvestades - учитывая
endassetõmbunud - замкнутый
väljendusviis - способ выражения
kaisukarudele - мягким медведям
häbelik - застенчивый
teismeline - подросток
eemale - в сторону
saamise - получение
eesmärg - цель
üha - все больше
moodustas - составил
kolmeliikmelise - трехчленный
Kuigi - Хотя
võimed - способности
ilmnesid - проявились
laiemalt - шире
esineda - выступать
sage - частый
kaudu - через
meenutama - напоминать
saatuslik - роковой
koonduma - сосредотачиваться
kavatsusega - намерением
Hoolimata - Несмотря на
algul vastu - сначала против
leebus alles
lahkusin - ушел
isegi - даже
tähendaks - означало бы
rahvusvaheline - международный
ujedale - застенчивому
mõistad - понимаешь
takerduda - застрять
vaeselt - бедно
tundmatu - неизвестный
usuvad - верят
eesmärgi täitumiseni - до достижения цели
Tegelikkus - Реальность
keskenduma - сосредотачиваться
Eranditult - без исключения
valem - формула
sundtegevus - принудительное действие
kirglikult - страстно
täie hingega
keskpärased - средние
ei saavuta - не достигают
vähimatki - никаких
tuimalt - равнодушно
väljapaistev - выдающийся
vetsus - в туалете
põnev - интересный
pooleli jäi - осталось незаконченным
niivõrd - настолько
kokku puutuma - сталкиваться
eristab - отличает
vahe - разница
mängleva kergusega - с легкостью
